1111111111111111111111111111111111111111111111111111111111111111111111111111111111111111111111111111
1111111111111111111111111111111111111111111111011111111111111111111111111111111111111111111111111111
1111111111111111111111111111111111111111111100000011111111111111111111111111111111111111111111111111
1110111011111111111111111111111111111111111000000001111111111111111111111111111111111111111111111111
1110000000111111000111111111111111111111110000000000111111111111111111111111111111111111111111111111
1100000000010100000001111111111111111111100000000000011111111111111111111111111111111111111111111111
1000000000000000000000011111111111111110000000000000001111111111111111111111111111111111111111111111
0000000000000000000000001111111111110000000000000000000111111111111111111111111111111111111111111111
1000000000000000000000000111111111000000000000000000000111111111111111111111111111111111111111111111
1000000000000000000000000000111100000000000000000000000011111111111111111111111111111111111111111111
1100000000000000000000000000000001000000000000000000000001111111111111111111111111111111111111111111
1100000000000000000000000011000011100000000000000000000000111111111111111111111111111111111111111111
1110000000000000000000000001111111000000000000000000000000111111111111111111111111111111111111111111
1111000000000000000000000000011110000000000000000000000000011111111111111111111111111111111111111111
1111111000000000000000000000000000000000000000000000000000011111111111111111111111111111111111111111
1111111110000000000000000000000000000000000000000000000000000001111111111111111111111111111111111111
1111111111100000000000000000000000000000000000000000000000000000111111111111111111111111111111111111
1111111111111111111100000000000000000000000000000000000000000000011111111111111111111111111111111111
1111111111111111111111100000000000000000000000111100000000000000011111111111111111111111111111111111
1111111111111111111111110000000000000000000000111100000000000000011111111111111111111111100001111111
1111111111111111111111111000000000000000000000111100000000000000011111111111111111111100000000011111
1111111111111111111111111100000000000000000000111110000000000000011111111111111111110000000000001111
1111111111111111111111111110000000000000000000111111000000000000011111111111111111100000000000000111
1111111111111111111111111110000000000000000000011111100000000000111111111111111111000000000000000111
1111111111111111111111111110000000000000000000001111111000000001111111111111111100000000000000000011
1111111111111111111111111000000000111100000000000111111111100111111111111111111000000000000000000011
1111111110000000011111100000000001111100000000000001111111111111111111111111111000000000000000000011
1111111100000000000000000000000011111110000010000000111111111111111111111111110000000000000000000011
1111100000000000000000000000000011111110000011000000001111111111111111111111100000001100000000000001
1000000000000000000000000000000011111110000011000000000011111111111111111111100000011110000000000001
1000000000000000000011100000000011111110000111100000000001111111111111111111000000011111000000000001
1000000000000000000111111000000011111100000111100000000000111111111111111111000000011111000000000001
1100000000000000111111111000000000111000001111110000000000011111111111111111000000011111000000000011
1100000000000000111111111000000000000000001111111000000000001111111111111110000000111111000000000011
1110000000000001111111111100000000000000011111111100000000000111111111111100000000111111000000000011
1111000000000011111111111100000000000000011111111110000000000011111111111000000000111110000000001111
1111100000000011111111111000000000000000011111111111000000000000111111100000000001111110000000111111
1111110000000011111111111000000000000000111111111111100000000000000000000000000000111110000001111111
1111111000000011111111111000000000000000111111111111111000000000000000000000000000011100000011111111
1111111110000011111111110000000000000001111111111111111110000000000000000000001100001100000011111111
1111111111001111111111100000000000000011111111111111111111110000000000000000011111000000000011111111
1111111111111111111111000000000000000111111111111111111111111111111111110011111111100000000011111111
1111111111111111111000000000000000011111111111111111111111111111111111111111111110000000000011111111
1111111111111111111000000000000000011111111111111111111111111111111111111111111000000000000000111111
1111111111111000000000000000000000111111111111111111111111111111111111111111110000000000000000011111
1111111110000000000000000000000001111111111111111111100011111111111111111111100000000000000000001111
1111111100000000000000000000000111111111111111111110000001111111111111111111100000000000000000000111
1111110000000000000000000000001111111111111111111000000000111111100011111111000000000000000000000011
1111000000000000000000000000111111111111111111100000000000011111000001111111000000000000000000000011
1111000000000000000000000001111111111111111111000000000000001110000001111111000000000000000000000011
1110000000000000000000001111111111111111111110000000000000000110000001111110000000000000000000000011
1100000000000000000001111111111111111111111100000000000000000000000001111110000000000000000000000011
1100000000000000001111111111111111111111111000000000000000000000000001111110000000000000000000000011
1110000000000011111111111111111111111111110000000000000000000000000001111110000000000000000000000011
1111111000001111111111111111111111111111100000000000000000000000000001111111000000000000000000000011
1111111111111111111111111111111111111111000000000000000000000000000001111111100000000000000000000001
1111111111111111111111111111111111111110000000000000011111000000000000111111100000000000000000000001
1111111111111111111111111111111111111110000000000000011111100000000000011111110000000000000000000001
1111111111111111111111111111111111111110000000000000111111110000000000011111111000000000000000000001
1111111111111111111111111111111111111111000000000001111111110000000000001111111110000000000000000000
1111111111111111111111111111111111111111110000000111111111110000000000000111111111000000000000000000
1111111111111111111111111111111111111111111111111111111111110000000000000011111111111000000000000000
1111111111111111111111111110111111111111111111111111111111110000000000000001111111111111111000000000
1111111111111111111111111000001111111111111111111111111111100000000000000000111111111111111000000000
1111111111111111111111110000000011111111111111111111111111000000000000000000011111111111111100000000
1111111111111111111111100000000000011111111111111111111000000000000000000000001111111111111100000000
1111111111111111111111100000000000000111111111111111100000000000000000000000000111111111111100000000
1111111111111111111110000000000000000000111111111100000000000000000000000000000001111111111100000000
1111111111111111111000000000000000000000000000000000000000000000000000000000000000011111111000000000
1111111111111111100000000000000000000000000000000000000000000000000000000000000000000111110000000000
1111000011111100000000000000000000000000000000000000000000000000000000000000000000000000000000000000
1111000000000000000000000000000000000000000000000000000000000000000000000000000000000000000000000001
1111100000000000000000000000000000000000000000000000000000011111100000000000000000000000000000000001
1111111111000000000000000000000000000000000000000000000111111111111111100000000000000000000000000011
1111111111111111111000000000000000000000000000000001111111111111111111111111100000000000000000000111
1111111111111111111000000000000000000000000000000111111111111111111111111111111100000000000000111110
1111111111111111111100000000000000000000000000011111111111111111111111111111111111000000001111111110
1111111111111111111100000000000000000000000001111111111111111111111111111111111111110000011111111110
1111111111111111111110000000000000000000000111111111111111111111111111111111111111111000011111111100
1111111111111111111111111000000000000000011111111111111111111111111111111111111111110000011111111100
1111001111111111111111111111111111101111111111111111111111111111111111111111111111100000011111111100
1110000111111111111111111111111111111111111111111111111111111111111111111111111110000000011111111100
1110000011111111111111111111111111111111111111111111111111111111111111111111111000000000001111111000
1110000001111111111111111111111111111111000000000011111111111111111111111111000000000000001111111000
1100000000111111111111111111111111111000000000000000001111111111111111111110000000000000000111110000
1100000000001111111111111111111111000000000000000000000000011111111111111000000000000000000111110000
1100000000000111111111111111111100000000000000000000000000000001111111000000000000011100000011100000
1000000000000001111111111111100000000000000000000000000000000000000000000000000000111110000000000000
1000000000000000000000000000000000000000000000000000000000000000000000000000000001111111000000000000
1000000000000000000000000000000000111000000000000000000000000000000000000000000011111111100000000000
1000000000000000000011110000000000111000000000000000000000000000000000000000001111111111110000000000
1100000000000000000011110000000001111000000000000000000000000000000000000000111111111111111000000000
1100000000000000000111110000000001110000000000111100000000000000000000000011111111111111111100000000
1100000000000000000111110000000000000000000011111111110000000000000000011111111111111111111110000000
1100000000000000000111110000000000000000001111111111111110000000000011111111111111111111111110000000
1110000000000000000111100000000000000000011111111111111111111111111111111111111111111111111111000000
1110000000000000000111000000000000000000111111111111111111111111111111111111111111111111111111100000
1111100000000000000000000000000000000000111111111111111111111111111111111111111111111111111111110000
1111111111111100000000000000000000000001111111111111111111111111111111111111111111111111111111111100
1111111111111111110000000000000000011111111111111111111111111111111111111111111111111111111111111110